10
10
1100000000
0100001010
0111001000
0001011101
0011110001
1110000110
1010001101
1101110011
1101010111
0000111011